1111111111111111111
1200000000000000021
1011010101010101101
1011010100010101101
1000000001000000001
1011010111110101101
1000000000000000001
1010110110110110101
1010110103010110101
1000000100010000001
1010110100010110101
1010110111110110101
1010110004000110101
1010000111110000101
1000110111110110001
1010010000000100101
1011011110111101101
1200000000000000021
1111111111111111111