1111111111111111111
1s000000000000000s1
1011010101010101101
1011010100010101101
1000000001000000001
1011010111110101101
1000000000000000001
101011011e110110101
10101101ggg10110101
10000001eee10000001
10101101eee10110101
1010110111110110101
101011000p000110101
1010000111110000101
1000110111110110001
1010010000000100101
1011011110111101101
1s000000000000000s1
1111111111111111111