1111111111111111111
1s000000000000000s1
1011010111110101101
1011010111110101101
100000000s000000001
1011011110111101101
1000000110110000001
1010110eeeee0110101
1010110efghe0110101
1000000111110000001
1010110000000110101
1010110111110110101
101011000p000110101
1010000111110000101
1000110111110110001
1010010000000100101
1011011110111101101
1s000000000000000s1
1111111111111111111